11111111111111111
10010000000CC0011
111001111100C0011
1000110000C010011
1000110C00PC10011
10001110000010111
11101110011000E11
11111111111111111
